TCCCCCCCCCCCCCCCCCCCCCCCCCCCCCCCCCCCCCCCCCCCY
VFFFFFFFFFFFFFFFFFFFFFFFFFFFFFFFFFFFFFFFFFFFV
VFFFFFFFFFFFFFFFFFFFFFFFFFFFFFFFFFFFFFFFFFFFV
VFFFFFFFFFFFFFFFFFFFFFFFFFFFFFFFFFFFFFFFFFFFV
VFFFFFFFFFFFFFFFFFFFFFFFFFFFFFFFFFFFFFFFFFFFV
VFFFFFFFFFFFFFFFFFFFFFFFFFFFFFFFFFFFFFFFFFFFV
VFFFFFFFFFFFFFFFFFFFFFFFFFFFFFFFFFFFFFFFFFFFV
VFFFFFFFFFFFFFFFFFFFFFFFFFFFFFFFFFFFFFFFFFFFV
VFFFFFFFFFFFFFFFFFFFFFFFFFFFFFFFFFFFFFFFFFFFV
VFFFFFFFFFFFFFFFFFFFFFFFFFFFFFFFFFFFFFFFFFFFV
VFFFFFFFFFFFFFFFFFFFFFFFFFFFFFFFFFFFFFFFFFFFV
VFFFFFFFFFFFFFFFFFFFFFFFFFFFFFFFFFFFFFFFFFFFV
VFFFFFFFFFFFFFFFFFFFFFFFFFFFFFFFFFFFFFFFFFFFV
VFFFFFFFFFFFFFFFFFFFFFFFFFFFFFFFFFFFFFFFFFFFV
VFFFFFFFFFFFFFFFFFFFFFFFFFFFFFFFFFFFFFFFFFFFV
VFFFFFFFFFFFFFFFFFFFFFFFFFFFFFFFFFFFFFFFFFFFV
VFFFFFFFFFFFFFFFFFFFFFFFFFFFFFFFFFFFFFFFFFFFV
VFFFFFFFFFFFFFFFFFFFFFFFFFFFFFFFFFFFFFFFFFFFV
VFFFFFFFFFFFFFFFFFFFFFFFFFFFFFFFFFFFFFFFFFFFV
VFFFFFFFFFFFFFFFFFFFFFFFFFFFFFFFFFFFFFFFFFFFV
VFFFFFFFFFFFFFFFFFFFFFFFFFFFFFFFFFFFFFFFFFFFV
VFFFFFFFFFFFFFFFFFFFFFFFFFFFFFFFFFFFFFFFFFFFV
UCCCCCCCCCCCCCCCCCCCCCCCCCCCCCCCCCCCCCCCCCCCI
